#S########  #####
# #   # #   #   #
#   x # # ### # #
##### # # #   # #
#     #     ### #
# ##### # ###   #
#       # ### ###
#############E###
