#S########  #####
# #   # #   #   #
#   # # # ### # #
##### # # #   # #
#     #     ### #
# ##### # ###   #
#       # ### ###
############# ###
