#S########  #####
# #   # #   #   #
#   # # # ### # #
##### # # #   # #
#     #     ### ##
# ##### # ###   #
#       # ### ###
#############E###
