#S###############
# #   # #   # # #
#   # # # ### # #
##### # # #   # #
#     #     ### #
# ##### # ###   #
#       # ### ###
#############E###
