#################
# #####   #   # E
#   ### #   # # #
### #   # # #   #
#     # # # # # #
S # #   # #   # #
#################
