#################
# #####xxx#xxx#xx
#   ###x#xxx#x#x#
### #xxx# # #xxx#
#xxxxx# # # # # #
Sx# #   # #   # #
#################
